+--+--+--+--+--+--+--+--+--+--+--+--+--+--+--+--+--+--+--+--+--+--+--+--+--+--+--+--+  +--+--+--+--+--+--+--+--+--+--+--+--+--+--+--+--+--+--+--+--+--+--+--+--+--+--+--+--+
|     |                 |     |              |        |        |        |        |                    |     |     |                       |     |                          |
+  +  +  +--+  +--+--+--+  +  +  +--+--+  +--+  +--+  +--+--+  +--+--+  +  +--+--+  +--+--+  +  +--+--+  +  +--+  +  +  +--+--+--+--+--+  +  +--+  +  +--+--+--+  +--+--+  +
|  |  |  |           |     |  |     |  |     |  |  |        |        |           |  |        |  |        |        |  |  |        |     |  |     |  |  |        |  |        |
+  +  +--+  +--+--+  +  +--+  +--+  +  +--+  +  +  +--+--+  +  +--+  +--+--+--+  +  +  +--+--+  +  +  +--+  +--+--+--+  +--+  +  +  +--+  +--+  +  +  +  +--+--+  +  +--+--+
|  |  |     |     |  |  |           |  |  |           |     |  |  |     |     |     |     |     |  |     |           |        |        |     |     |     |        |  |     |
+  +--+  +  +  +  +  +  +  +--+--+--+  +  +--+  +--+  +--+--+  +  +--+  +--+  +--+--+--+  +  +--+  +--+  +--+--+--+  +--+--+--+--+--+  +--+  +--+  +--+  +  +  +--+--+  +  +
|  |     |  |  |  |  |  |  |     |  |        |     |     |     |     |     |        |     |     |     |     |     |  |  |           |  |     |  |  |     |  |     |     |  |
+  +  +--+  +  +  +  +  +--+  +  +  +  +--+  +--+  +--+  +--+--+  +  +  +  +--+--+  +  +  +--+--+--+  +  +  +  +--+  +  +  +--+  +  +  +  +--+  +  +  +--+--+  +--+  +--+  +
|  |     |     |  |  |        |  |  |     |  |     |     |     |  |  |  |        |     |              |  |  |     |  |     |     |  |  |  |        |  |     |     |  |  |  |
+  +--+--+--+--+  +--+--+--+  +  +  +--+  +  +--+--+  +--+  +  +  +  +  +--+--+  +--+  +--+--+--+--+--+  +  +--+  +  +  +--+  +--+  +  +--+  +--+--+  +--+  +--+  +  +  +  +
|              |              |  |  |     |  |     |     |  |     |     |     |  |     |     |           |     |     |  |  |     |  |     |  |              |        |     |
+--+--+  +--+  +--+--+--+--+  +  +  +  +--+--+  +  +--+  +  +--+--+--+--+  +--+  +  +--+  +  +--+--+--+--+--+  +--+--+  +  +  +  +--+--+  +  +--+--+--+--+--+--+--+--+--+--+
|     |  |  |  |     |        |  |  |  |  |     |        |  |     |     |  |     |     |  |     |  |        |           |  |  |     |  |        |           |              |
+  +  +  +  +  +  +  +  +--+--+  +  +  +  +  +--+--+--+  +  +  +  +--+  +  +  +--+  +  +  +--+  +  +  +--+  +--+--+--+--+  +--+--+  +  +--+--+  +  +--+--+  +  +--+--+--+  +
|  |     |  |  |  |     |     |           |  |     |     |  |  |     |  |     |     |  |     |     |  |     |           |  |     |  |     |     |  |        |     |     |  |
+  +--+--+  +  +--+--+--+--+  +--+--+--+--+  +  +  +  +--+  +  +--+  +  +--+--+  +--+  +--+--+  +--+  +  +--+  +--+--+  +  +  +--+  +--+  +  +--+  +--+--+--+--+  +  +--+  +
|           |  |                    |     |  |  |  |        |     |           |     |  |     |  |     |  |     |     |     |  |     |     |     |        |     |     |     |
+--+--+  +--+  +  +  +--+--+--+--+--+  +  +  +  +  +  +  +--+--+  +--+--+  +  +--+  +  +  +  +  +  +--+  +--+--+  +  +  +  +  +  +--+  +  +--+  +--+--+  +--+  +--+--+  +  +
|        |  |  |  |  |           |     |     |  |  |  |  |     |     |  |  |        |     |     |     |  |        |     |     |        |        |     |     |     |     |  |
+  +--+--+  +  +  +  +  +--+--+  +  +--+--+--+  +  +  +  +  +  +--+  +  +  +--+--+--+  +--+--+--+--+--+  +  +--+--+--+--+--+--+--+--+--+  +  +--+  +  +--+  +  +--+  +--+--+
|     |           |  |        |  |        |     |  |  |  |  |  |        |     |        |     |     |     |        |                 |     |        |  |     |              |
+  +--+  +--+--+  +  +--+--+  +  +--+--+  +--+  +  +--+  +--+  +  +--+--+--+  +  +--+--+  +  +  +  +  +--+--+--+  +--+  +--+  +--+--+  +--+--+--+--+  +  +--+--+--+--+--+  +
|     |        |  |     |     |        |     |  |     |  |     |  |        |  |  |  |     |     |  |     |     |     |  |     |        |        |  |  |  |                 |
+--+  +--+--+--+  +--+--+  +--+--+--+  +  +  +  +  +  +  +  +--+  +  +--+--+  +  +  +  +--+--+--+  +--+  +  +  +--+  +  +--+--+  +  +--+  +--+  +  +  +  +  +--+--+--+  +--+
|     |     |     |        |        |  |  |  |  |  |  |  |        |  |     |  |        |        |     |  |  |        |  |        |        |  |     |     |     |     |     |
+  +--+  +  +  +--+  +  +--+  +--+--+  +  +  +  +--+  +  +--+--+--+  +  +  +  +--+--+--+  +  +  +  +  +  +  +--+--+--+  +  +--+--+--+--+  +  +--+--+--+--+--+  +  +--+--+  +
|     |  |     |  |  |        |        |  |  |     |  |  |        |  |  |  |     |     |  |  |     |     |        |     |  |        |  |  |     |           |     |     |  |
+--+  +  +  +--+  +  +--+  +--+  +--+--+  +  +--+  +  +  +  +  +  +  +  +  +--+  +  +--+  +--+--+  +--+--+--+--+  +  +--+  +  +--+  +  +  +--+  +  +--+--+  +--+--+  +  +  +
|     |  |        |     |     |  |        |        |  |     |  |     |  |  |     |              |  |     |        |        |  |     |  |  |     |        |     |     |     |
+  +--+--+--+  +--+--+  +--+  +  +  +--+--+--+--+  +  +--+--+--+--+  +--+  +  +  +--+--+--+--+  +  +  +  +  +--+--+--+--+--+  +  +--+  +  +  +--+--+  +  +--+  +  +--+--+--+
|           |        |     |  |  |  |     |     |  |  |                    |  |  |           |  |  |  |  |  |                 |  |     |  |     |     |  |     |  |        |
+--+--+--+  +--+--+--+--+--+  +  +  +  +  +  +--+  +  +--+--+--+--+--+--+--+  +  +  +--+--+--+  +  +  +  +  +  +--+--+  +--+--+  +  +--+  +--+  +--+  +  +  +--+  +--+--+  +
|                 |     |     |  |     |  |     |  |  |        |              |  |              |     |  |        |  |  |     |  |        |  |  |     |  |        |     |  |
+  +--+--+--+--+  +  +--+  +  +  +--+--+  +--+  +  +  +  +  +  +  +--+--+--+--+  +--+--+--+--+--+--+--+  +--+--+  +  +  +--+  +  +--+--+--+  +  +  +--+  +--+--+--+  +  +  +
|        |  |     |     |  |  |  |        |  |     |  |  |  |  |  |     |        |     |     |           |     |     |     |  |  |           |        |              |  |  |
+  +--+  +  +  +--+--+  +  +--+  +  +--+--+  +--+--+--+  +  +  +  +  +  +--+--+--+  +--+  +  +  +--+--+--+  +  +--+--+--+  +  +  +  +--+--+  +--+--+--+--+  +--+--+--+  +  +
|  |     |        |     |     |           |              |  |        |  |     |     |     |  |     |  |     |              |  |  |  |     |  |        |     |           |  |
+  +--+--+--+  +--+  +--+--+  +--+--+--+--+--+  +--+--+--+  +--+--+--+  +  +  +  +  +  +--+  +--+  +  +  +--+--+--+--+--+--+  +  +  +  +  +  +  +  +  +  +--+  +--+--+  +  +
|           |        |     |  |              |  |           |     |     |  |     |  |     |  |     |     |        |     |  |     |     |  |  |  |  |  |  |     |        |  |
+--+--+--+  +--+--+--+  +  +  +  +--+--+--+  +--+  +--+  +--+  +--+  +--+  +--+--+--+--+  +  +  +  +  +--+  +  +--+  +  +  +  +--+--+--+--+  +  +  +  +--+  +--+  +--+--+  +
|  |     |        |     |     |        |     |     |  |  |           |  |           |     |     |           |  |     |     |        |           |  |     |  |  |  |        |
+  +  +  +--+--+  +  +--+--+--+--+--+  +  +--+  +--+  +  +  +--+--+--+  +--+--+--+  +  +--+--+--+  +--+--+--+  +  +  +  +--+--+--+  +  +--+--+--+  +--+  +  +  +  +  +--+--+
|  |  |  |        |     |     |     |  |     |  |     |  |  |        |           |        |        |  |     |     |  |           |     |     |  |     |     |     |  |     |
+  +  +  +  +--+--+--+  +  +  +--+  +  +--+  +  +  +--+  +--+  +--+  +--+--+--+  +--+--+  +--+--+--+  +  +--+--+  +--+--+--+--+  +  +--+  +  +  +--+  +--+--+--+--+  +  +  +
|  |  |  |  |     |     |  |  |     |     |     |     |        |     |  |              |              |           |           |  |        |  |     |                    |  |
+  +  +  +  +  +  +  +--+  +  +  +--+--+  +--+--+  +  +--+--+--+  +--+  +  +--+--+--+  +--+--+  +--+--+--+--+--+--+  +--+--+--+  +  +--+--+--+  +--+--+--+--+--+--+--+--+  +
|     |  |  |  |     |     |  |  |     |     |     |  |     |     |  |     |  |     |  |        |        |     |  |        |     |  |        |           |                 |
+--+  +--+  +  +--+  +  +--+  +  +  +  +--+  +--+--+  +  +--+  +--+  +--+  +  +  +--+  +  +--+--+  +--+  +  +  +  +--+  +--+  +--+--+  +--+  +  +--+--+  +  +  +--+--+--+  +
|  |     |  |  |     |     |        |        |     |  |     |  |        |     |        |     |     |        |        |              |  |  |     |        |  |     |     |  |
+  +--+  +  +  +  +--+--+  +--+--+--+--+  +--+  +  +  +--+  +  +--+--+  +  +--+--+--+  +--+  +  +  +--+--+--+--+--+  +--+--+--+--+  +  +  +--+--+--+  +--+  +--+  +  +  +--+
|  |  |  |     |  |     |        |     |        |     |     |        |     |        |     |  |  |  |     |              |           |  |     |     |  |  |  |     |  |     |
+  +  +  +--+--+  +  +  +--+--+  +  +  +--+  +--+--+  +  +--+--+--+  +  +--+  +  +  +--+  +  +  +  +  +  +--+--+--+  +  +  +--+--+--+  +  +  +  +  +  +  +  +  +--+  +--+  +
|     |              |           |  |     |        |     |           |     |  |  |        |     |     |     |        |  |              |  |  |  |     |     |  |  |     |  |
+--+  +--+--+--+--+  +--+--+--+--+  +--+--+--+--+  +--+--+  +--+--+--+--+  +  +--+--+--+--+--+--+--+--+--+  +--+--+--+--+--+--+--+--+  +  +  +  +  +--+--+--+  +  +--+  +--+
|  |              |  |     |     |                 |  |     |     |        |     |     |        |           |                 |        |  |     |  |        |        |     |
+  +--+--+--+--+  +  +--+  +  +--+  +--+--+--+--+--+  +  +--+--+  +  +--+--+--+  +  +  +  +--+  +  +--+  +--+  +--+--+--+  +  +  +--+--+--+--+--+  +  +--+  +--+  +--+--+  +
|  |        |     |     |     |                       |  |     |  |           |     |     |     |     |  |           |     |  |  |        |     |     |  |     |  |        |
+  +  +--+  +  +--+--+  +  +  +  +--+--+--+--+--+  +--+  +  +  +  +--+--+--+  +--+--+--+  +  +--+--+  +--+  +--+--+  +--+--+  +  +  +--+  +--+  +--+--+  +--+  +--+  +  +--+
|  |  |              |  |  |  |        |        |     |  |  |     |        |           |  |  |        |     |        |        |  |     |        |        |  |        |     |
+  +--+  +--+--+--+  +  +--+  +  +--+--+  +--+  +--+--+  +  +--+--+  +--+--+--+--+  +  +  +--+  +--+--+  +--+  +--+--+  +--+--+  +  +  +--+  +--+--+--+  +  +--+--+--+--+  +
|  |     |        |  |     |     |     |     |        |  |  |     |                 |  |        |  |     |  |  |     |        |     |     |                       |        |
+  +  +--+--+--+  +  +--+  +--+--+  +  +--+  +--+--+  +  +  +  +  +--+--+--+--+--+--+  +--+--+  +  +  +--+  +  +  +--+--+--+  +--+--+--+  +--+--+--+--+--+  +--+  +--+--+  +
|     |           |     |  |     |  |  |  |  |     |     |     |     |        |     |  |     |     |  |     |  |  |           |        |  |     |           |     |     |  |
+  +--+--+  +--+--+--+  +  +  +  +  +  +  +  +  +--+--+--+--+--+--+  +  +--+  +  +  +  +  +  +--+--+  +  +--+  +  +  +--+--+--+  +--+  +  +--+  +  +--+--+--+  +--+  +  +--+
|           |        |  |     |  |  |        |        |        |     |     |     |  |     |  |        |  |     |  |           |  |  |        |     |        |  |     |     |
+--+--+  +--+  +--+  +  +  +--+--+  +--+--+--+  +--+  +  +--+  +  +  +--+  +  +--+--+--+--+  +  +  +--+  +  +--+  +--+--+--+  +  +  +--+--+  +--+--+  +--+  +--+  +--+--+  +
|        |  |  |     |  |  |     |  |  |        |           |     |        |              |  |  |     |  |     |              |     |        |        |           |     |  |
+  +--+--+  +  +  +  +  +  +  +  +  +  +  +--+  +  +--+--+--+--+--+--+--+  +--+--+--+--+  +  +  +--+--+  +  +--+  +--+--+--+--+--+--+  +  +--+--+--+--+  +--+--+--+--+  +  +
|        |     |  |  |     |  |     |     |     |        |                 |     |        |  |        |  |  |     |        |        |  |  |        |     |           |     |
+  +--+  +--+--+  +  +--+--+  +--+--+--+--+  +--+--+--+  +  +--+--+--+--+  +  +  +--+  +--+  +--+--+  +  +  +  +--+  +--+  +  +--+  +  +  +  +--+  +  +--+--+--+  +  +--+  +
|     |     |     |     |     |              |     |     |              |  |  |     |  |     |           |  |  |  |  |     |     |     |  |     |  |  |           |  |     |
+  +--+--+  +  +--+--+--+  +--+  +  +  +--+  +--+  +  +--+--+--+--+--+  +  +--+--+  +  +  +--+--+--+--+--+  +  +  +  +  +--+--+  +--+--+  +--+--+  +  +  +--+--+--+  +  +--+
|  |     |        |        |     |  |  |        |     |              |  |        |        |     |        |  |  |     |     |  |  |     |              |  |        |     |  |
+--+  +  +--+--+--+  +--+--+--+--+  +--+  +--+  +--+--+  +--+--+--+--+  +--+--+  +--+--+--+  +  +  +--+  +--+  +  +--+--+  +  +  +--+  +--+--+--+--+--+  +  +--+  +--+--+  +
|     |     |     |  |           |     |  |  |        |                 |     |  |           |  |  |        |  |  |        |  |     |        |           |  |     |        |
+  +--+--+  +  +  +  +--+--+--+  +--+  +  +  +--+--+  +--+--+--+--+--+--+  +  +  +--+  +--+--+  +  +--+--+  +  +  +  +--+  +  +--+  +--+--+  +  +--+--+  +  +  +--+  +--+--+
|  |     |     |  |        |  |        |     |     |     |     |           |  |     |  |        |     |     |  |  |     |  |     |  |     |  |        |     |        |     |
+  +  +  +--+--+  +--+--+  +  +--+  +--+--+--+  +--+  +  +  +  +  +--+--+--+--+  +  +--+  +--+--+--+  +  +  +  +  +--+  +  +--+  +  +  +  +  +--+--+  +--+  +--+--+--+  +  +
|     |  |     |           |        |     |     |     |  |  |     |     |     |  |     |  |        |  |  |     |  |     |     |     |  |     |     |     |     |        |  |
+--+--+  +  +--+--+--+--+--+--+  +--+  +  +  +--+  +--+  +  +--+--+  +--+  +  +  +--+  +  +  +--+--+  +  +--+--+  +  +--+--+--+--+  +  +  +  +  +  +--+  +--+  +  +--+--+  +
|        |  |           |     |     |  |  |     |  |     |                 |     |     |  |  |        |           |           |     |  |  |     |     |  |  |  |        |  |
+  +--+--+  +  +  +--+  +  +  +--+--+  +  +--+  +  +--+--+--+  +--+--+--+--+--+  +--+  +  +  +--+  +--+--+--+--+--+  +--+--+  +  +--+  +  +  +--+--+  +  +  +  +  +--+  +--+
|  |           |  |  |     |     |     |              |     |        |     |  |     |     |  |     |           |     |        |        |  |  |        |     |     |  |     |
+  +  +  +--+--+  +  +--+  +--+  +  +--+--+  +--+--+  +  +--+--+--+  +  +  +  +--+  +--+--+  +  +--+--+--+  +  +  +--+  +--+--+  +--+--+--+  +  +--+--+  +--+--+--+  +--+  +
|  |  |     |     |     |  |  |  |  |     |     |     |  |        |  |  |  |     |     |     |  |     |  |  |  |     |        |     |        |  |     |  |  |     |  |     |
+  +  +--+--+  +--+--+  +  +  +  +  +  +  +--+  +  +--+  +  +  +  +  +  +  +  +--+  +  +  +--+  +  +  +  +  +--+--+  +--+--+  +--+--+  +--+--+  +  +  +  +  +  +--+  +  +--+
|  |  |     |           |     |     |  |     |  |  |  |     |  |     |  |  |     |  |  |        |  |     |           |     |        |  |        |  |  |     |              |
+  +--+  +  +--+--+--+--+--+--+--+--+  +--+--+  +  +  +--+  +--+--+--+  +  +--+  +  +  +--+  +--+  +  +  +--+--+--+--+  +  +--+--+  +  +--+--+  +  +  +--+--+--+--+--+--+  +
|  |     |  |                    |  |           |     |  |     |     |  |     |  |  |  |     |  |  |  |     |     |     |  |  |     |        |  |  |        |     |        |
+  +  +--+  +  +  +--+--+--+--+  +  +--+  +--+--+--+  +  +--+  +  +  +  +--+  +  +  +--+  +--+  +  +  +--+--+  +  +  +--+  +  +  +  +--+--+  +--+  +--+--+  +--+  +  +--+--+
|        |     |  |  |        |  |  |           |     |     |     |  |  |     |  |     |  |     |  |  |     |  |        |  |  |  |     |  |        |     |  |     |        |
+  +--+--+--+--+  +  +  +--+--+  +  +  +--+--+--+  +--+--+  +--+--+  +  +  +--+  +--+  +  +  +  +  +  +  +  +--+--+--+  +  +  +  +--+  +  +--+  +--+--+  +  +  +--+--+--+--+
|  |        |     |     |        |              |           |     |  |  |        |     |     |  |  |     |              |     |     |  |  |     |  |                 |     |
+--+  +--+  +  +--+  +--+--+  +--+--+--+  +--+  +--+--+--+--+  +  +  +--+  +--+  +  +--+--+--+  +  +--+--+--+--+--+--+--+--+  +--+--+  +  +  +--+  +  +--+--+--+--+--+  +  +
|     |     |              |  |        |     |        |     |  |  |        |     |  |        |  |  |        |  |              |        |     |     |  |              |  |  |
+  +--+  +  +--+--+--+--+  +  +  +--+--+--+  +--+--+  +  +  +  +--+--+--+--+--+--+  +  +--+--+  +  +--+--+  +  +  +  +--+--+--+  +--+--+--+  +  +--+  +  +--+--+--+  +  +  +
|  |  |  |  |           |  |  |           |  |  |     |  |     |                    |           |  |        |     |     |     |  |        |  |        |     |        |  |  |
+  +  +  +--+  +--+--+  +--+  +--+  +--+  +  +  +  +--+  +--+--+  +--+--+--+  +--+--+--+--+--+--+  +  +--+--+--+--+  +  +  +  +  +  +--+  +  +--+--+--+  +  +  +--+--+  +  +
|     |     |  |  |     |     |        |     |        |        |  |     |  |     |        |     |  |           |     |     |  |     |              |     |  |           |  |
+--+--+  +  +  +  +  +--+  +--+--+--+--+--+--+--+--+--+--+--+  +  +  +  +  +--+  +  +  +--+  +  +  +  +--+--+  +  +--+--+--+  +--+--+--+--+--+--+--+  +--+  +--+--+  +--+  +
|        |  |  |     |     |           |                    |        |  |  |     |  |        |     |        |     |        |     |     |  |           |     |     |     |  |
+  +--+--+  +  +--+--+  +  +  +--+--+  +--+--+--+--+--+  +  +--+--+--+  +  +  +--+  +--+--+--+--+--+--+--+--+--+--+  +--+  +--+  +  +  +  +  +--+--+  +  +  +  +  +--+  +--+
|  |     |  |  |     |  |  |     |     |           |  |  |           |     |  |     |        |     |           |     |     |  |     |     |        |  |  |  |  |  |  |     |
+  +  +  +  +  +  +  +  +  +--+  +  +--+  +--+--+  +  +  +  +--+--+  +--+--+  +  +--+--+--+  +  +--+  +--+--+  +  +--+  +--+  +  +--+--+--+--+--+  +  +  +  +  +  +  +--+  +
|  |  |  |  |  |  |     |     |  |  |     |        |     |        |        |  |  |                    |     |  |  |     |     |              |     |  |  |  |  |           |
+  +  +--+  +  +--+--+--+  +--+  +  +  +--+  +--+--+--+--+  +--+--+  +--+  +  +  +  +--+--+--+--+  +--+  +  +  +--+  +  +  +--+--+--+--+--+--+  +--+  +  +  +--+--+--+--+--+
|  |  |     |     |     |  |     |  |  |     |        |     |     |  |        |     |              |     |  |     |  |  |  |     |        |     |     |  |  |              |
+  +  +  +--+--+  +  +  +  +  +--+  +  +  +--+  +--+  +  +--+  +  +--+  +--+--+--+--+  +--+--+--+  +  +--+  +--+  +  +  +  +  +  +  +--+  +  +  +--+--+  +  +  +--+--+--+  +
|  |     |        |  |  |     |  |     |  |        |     |     |     |           |     |           |  |     |  |  |  |  |     |     |     |  |        |  |  |     |     |  |
+  +  +--+  +  +--+  +  +--+  +  +--+--+  +--+--+--+--+--+  +--+--+  +--+--+--+  +--+--+--+  +  +--+  +  +  +  +  +  +--+--+  +--+--+  +--+--+--+  +--+  +  +--+  +--+  +  +
|  |        |  |     |        |     |  |  |                 |                 |           |  |  |     |  |     |  |  |     |     |  |  |        |     |  |     |     |     |
+  +--+  +--+  +  +--+--+--+--+--+  +  +  +  +--+--+--+--+--+  +--+--+--+--+  +--+--+--+  +  +--+  +--+  +  +--+  +  +  +  +--+  +  +  +  +--+  +--+  +  +--+  +--+  +--+--+
|     |     |  |        |     |     |  |  |     |        |     |     |     |     |     |  |  |     |     |     |        |     |     |        |        |  |  |  |  |     |  |
+--+  +  +  +--+  +  +--+  +  +  +--+  +  +--+  +  +--+  +  +  +  +  +--+  +--+  +  +  +  +  +  +--+--+--+--+--+--+--+--+--+  +--+--+--+--+  +--+--+--+  +  +  +  +--+  +  +
|     |  |        |        |           |        |     |     |     |           |     |  |     |                                               |              |              |
+--+--+--+--+--+--+--+--+--+--+--+--+--+--+--+--+--+--+--+--+--+--+--+--+--+--+--+--+  +--+--+--+--+--+--+--+--+--+--+--+--+--+--+--+--+--+--+--+--+--+--+--+--+--+--+--+--+